HF-IFR - Institutt for filosofi og religionsvitenskap
HF-IHS - Institutt for historiske studier
HF-IKM - Institutt for kunst- og medievitenskap
HF-IM - Institutt for musikk
HF-ISL - Institutt for språk og litteratur
HF-KULT - Institutt for tverrfaglige kulturstudier
DMF-IKMM - Institutt for kreftforskning og molekylær medisin
DMF-LBK - Institutt for laboratoriemedisin, barne- og kvinnesykdommer
DMF-INM - Institutt for nevromedisin
DMF-ISM - Institutt for samfunnsmedisin
DMF-ISB - Institutt for sirkulasjon og bildediagnostikk
AB-KIT - Institutt for billedkunst - Kunstakademiet i Trondheim
AB-BYPLAN - Institutt for byforming og planlegging
AB-BKFF - Institutt for byggekunst, form og farge
AB-BKHT - Institutt for byggekunst, historie og teknologi
AB-BKPF - Institutt for byggekunst, prosjektering og forvaltning
IME-IDI - Institutt for datateknikk og informasjonsvitenskap
IME-IET - Institutt for elektronikk og telekommunikasjon
IME-ELKRAFT - Institutt for elkraftteknikk
IME-IMF - Institutt for matematiske fag
IME-ITK - Institutt for teknisk kybernetikk
IME-ITEM - Institutt for telematikk
IVT-BAT - Institutt for bygg, anlegg og transport
IVT-EPT - Institutt for energi- og prosessteknikk
IVT-IGB - Institutt for geologi og bergteknikk
IVT-KT - Institutt for konstruksjonsteknikk
IVT-IMT - Institutt for marin teknikk
IVT-IPT - Institutt for petroleumsteknologi og anvendt geofysikk
IVT-IPK - Institutt for produksjons- og kvalitetsteknikk
IVT-IPD - Institutt for produktdesign
IVT-IPM - Institutt for produktutvikling og materialer
IVT-IVM - Institutt for vann- og miljøteknikk
NT-IBI - Institutt for biologi
NT-IBT - Institutt for bioteknologi
NT-IFY - Institutt for fysikk
NT-IKJ - Institutt for kjemi
NT-IKP - Institutt for kjemisk prosessteknologi
NT-IMTE - Institutt for materialteknologi
SVT-GEO - Geografisk institutt
SVT-IOT - Institutt for industriell økonomi og teknologiledelse
SVT-IPL - Institutt for pedagogikk og livslang læring
SVT-ISO - Institutt for samfunnsøkonomi
SVT-ISH - Institutt for sosialt arbeid og helsevitenskap
SVT-ISS - Institutt for sosiologi og statsvitenskap
SVT-IVR - Institutt for voksnes læring og rådgivningsvitenskap
SVT-NOSEB - Norsk senter for barneforskning
SVT-PED - Pedagogisk institutt
SVT-PLU - Program for lærerutdanning
SVT-PSY - Psykologisk institutt
SVT-SANT - Sosialantropologisk institutt
